entityName	íšŒì‚¬ëª… (CIK ê¸°ì¤€)
facts	ë³´ê³ ëœ ëª¨ë“  ê³µì‹œ í•­ëª©ë“¤
us-gaap	ë¯¸êµ­ íšŒê³„ ê¸°ì¤€ í•­ëª©ë“¤ (ì¬ë¬´ì œí‘œ ì¤‘ì‹¬)
dei	ê³µì‹œ ì¼ë°˜ ì •ë³´ (ì£¼ì‹ìˆ˜ ë“±)
NetIncomeLoss, Assets ë“±	ê³µì‹œ í•­ëª© (ê° í•­ëª©ì€ keyì´ë©°, í•­ëª©ëª…ì€ ì •í•´ì§„ GAAP ëª…ì¹­)
units	í•­ëª©ì˜ ë‹¨ìœ„ë³„ ìˆ˜ì¹˜ ëª¨ìŒ (USD, shares, etc)
val	ì‹¤ì œ ê°’
start, end	íšŒê³„ê¸°ê°„ ì‹œì‘/ì¢…ë£Œì¼
fp	íšŒê³„ ë¶„ê¸° (1Q, 2Q, 3Q, FY ë“±)
form	ê³µì‹œ ì¢…ë¥˜ (10-K, 10-Q ë“±)
filed	ì‹¤ì œ ì œì¶œì¼
frame	íšŒê³„ ê¸°ê°„ ì½”ë“œ (CY2022, CY2023Q1 ë“±)


    facts ë‚´ë¶€ í•„ë“œ êµ¬ì¡°
start, end	íšŒê³„ê¸°ê°„ ì‹œì‘ì¼/ì¢…ë£Œì¼
val	ê°’ (ìˆ«ì, ë¹„ìœ¨, ì£¼ì‹ìˆ˜ ë“±)
accn	SEC ê³µì‹œ ë¬¸ì„œ ë²ˆí˜¸
fy	íšŒê³„ ì—°ë„
fp	íšŒê³„ ë¶„ê¸° (Q1, Q2, Q3, FY ë“±)
form	ê³µì‹œ ì–‘ì‹ (10-K, 10-Q ë“±)
filed	SEC ì œì¶œì¼
frame	ê¸°ê°„ í”„ë ˆì„ ì½”ë“œ (ì˜ˆ: CY2023Q1, CY2022)


    us-gaap (ë¯¸êµ­ íšŒê³„ê¸°ì¤€ - ëŒ€ë¶€ë¶„ì˜ ì¬ë¬´ì •ë³´ê°€ ì—¬ê¸°ì— ìˆìŒ)

ğŸ‘‰ ì†ìµê³„ì‚°ì„œ ê´€ë ¨
í•­ëª©ëª…	ì„¤ëª…
Revenues ë˜ëŠ” RevenueFromContractWithCustomer	ì´ ë§¤ì¶œ
CostOfRevenue	ë§¤ì¶œì›ê°€
GrossProfit	ë§¤ì¶œì´ì´ìµ
OperatingIncomeLoss	ì˜ì—…ì´ìµ
NetIncomeLoss	ë‹¹ê¸°ìˆœì´ìµ
EarningsPerShareBasic	ê¸°ë³¸ ì£¼ë‹¹ìˆœì´ìµ (EPS)
EarningsPerShareDiluted	í¬ì„ EPS
WeightedAverageNumberOfSharesOutstandingBasic	ì£¼ì‹ìˆ˜(Basic)
IncomeTaxExpenseBenefit	ë²•ì¸ì„¸ ë¹„ìš©
InterestExpense	ì´ì ë¹„ìš©


ğŸ‘‰ ì¬ë¬´ìƒíƒœí‘œ ê´€ë ¨
í•­ëª©ëª…	ì„¤ëª…
Assets	ì´ ìì‚°
CurrentAssets	ìœ ë™ ìì‚°
NoncurrentAssets	ë¹„ìœ ë™ ìì‚°
Liabilities	ì´ ë¶€ì±„
CurrentLiabilities	ìœ ë™ ë¶€ì±„
LongTermDebtNoncurrent	ì¥ê¸°ë¶€ì±„
StockholdersEquity	ìë³¸ ì´ì•¡
RetainedEarningsAccumulatedDeficit	ì´ìµì‰ì—¬ê¸ˆ
CashAndCashEquivalentsAtCarryingValue	í˜„ê¸ˆì„± ìì‚°


ğŸ‘‰ í˜„ê¸ˆíë¦„í‘œ ê´€ë ¨
í•­ëª©ëª…	ì„¤ëª…
NetCashProvidedByUsedInOperatingActivities	ì˜ì—…í™œë™ í˜„ê¸ˆíë¦„
NetCashProvidedByUsedInInvestingActivities	íˆ¬ìí™œë™ í˜„ê¸ˆíë¦„
NetCashProvidedByUsedInFinancingActivities	ì¬ë¬´í™œë™ í˜„ê¸ˆíë¦„
PaymentsOfDividends	ë°°ë‹¹ê¸ˆ ì§€ê¸‰ ì´ì•¡


ğŸ‘‰ ê¸°íƒ€ ì£¼ìš” í•­ëª©
í•­ëª©ëª…	ì„¤ëª…
CommonStockDividendsPerShareDeclared	ì£¼ë‹¹ ë°°ë‹¹ê¸ˆ
MarketableSecuritiesCurrent	ë‹¨ê¸°íˆ¬ììì‚°
InventoryNet	ì¬ê³ ìì‚°
Goodwill	ì˜ì—…ê¶Œ



